R  648	488
NO textures/bluebrick.xpm
SO textures/redbrick.xpm
WE textures/mossy.xpm
EA textures/stone.xpm

S textures/pillar.xpm
F textures/sand.xpm
C textures/wood.xpm
1  1  1  1  1  1  1  1  1  1  1  1  1  1  1  1  1  1  1  1  1  1  1  1
1  0  0  0  0  0  0  0  0  0  0  0  0  0  0  0  0  0  0  0  0  0  0  1
1  0  0  0  0  0  0  0  0  0  0  0  0  0  0  0  0  0  0  0  0  0  0  1
1  0  0  0  0  0  0  0  0  0  0  0  0  0  0  0  0  0  0  0  0  0  0  1
1  0  0  0  0  0  1  1  1  1  1  0  0  0  0  1  0  1  0  1  0  0  0  1
1  0  0  0  0  0  1  0  0  0  1  0  0  0  0  0  0  0  0  0  0  0  0  1
1  0  0  0  0  0  1  0  0  0  1  0  0  0  0  1  0  0  0  1  0  0  0  1
1  0  0  0  0  0  1  0  0  0  1  0  0  0  0  0  0  0  0  0  0  0  0  1
1  0  0  0  0  0  1  1  0  1  1  0  0  0  0  1  0  1  0  1  0  0  0  1
1  0  0  0  0  0  0  0  0  0  0  0  0  0  0  0  0  0  0  0  0  0  0  1
1  0  0  0  0  0  0  0  0  0  0  0  0  0  0  0  0  0  0  0  0  0  0  1
1  0  0  0  2  0  0  0  0  0  0  0  0  0  0  0  0  0  0  0  0  0  0  1
1  0  0  2  2  2  0  0  E  0  0  0  0  0  0  0  0  0  0  0  0  0  0  1
1  0  0  0  2  0  0  0  0  0  0  0  0  0  0  0  0  0  0  0  0  0  0  1
1  0  0  0  0  0  0  0  0  0  0  0  0  0  0  0  0  0  0  0  0  0  0  1
1  0  0  0  0  0  0  0  0  0  0  0  0  0  0  2  0  2  0  0  0  0  0  1
1  1  1  1  1  1  1  1  1  0  0  0  0  0  0  0  2  2  0  0  0  0  0  1
1  1  0  1  0  0  0  0  1  0  0  0  0  0  0  0  0  2  0  0  0  0  0  1
1  1  0  0  0  0  1  0  1  0  0  0  0  0  0  0  0  2  2  0  0  0  0  1
1  1  0  1  0  0  0  0  1  0  0  0  0  0  0  0  0  2  0  2  0  0  0  1
1  1  0  1  1  1  1  1  1  0  0  0  0  0  0  0  0  0  0  0  0  0  0  1
1  1  0  0  0  0  0  0  0  0  0  0  0  0  0  0  0  0  0  0  0  0  0  1
1  1  1  1  1  1  1  1  1  0  0  0  0  0  0  0  0  0  0  0  0  0  0  1
1  1  1  1  1  1  1  1  1  1  1  1  1  1  1  1  1  1  1  1  1  1  1  1